EWEEEEEEEE
EEEEEEEEEE
EWEEEEEEEE
EEEEEEEAEE
EEEEEEEEEE
EEEEEEEEEE
EEEWEEEEEE
EWEEEEEEEE
EEEWEEEEEE
DEEWEEEEEE
