EWEEEEEEEE
EEWWWWWEEE
EWEEEWEEEE
EEEEEWWAWE
EEEWWWWWWE
EEEEEEEEEE
EEEWEEEEEE
EWEEEEEEEE
EEEWEEEWEE
DEEWEEEEEE