EWEEEEEEEE
EEWWWWWEEE
EWEEEEEEEE
EEEEEEEAEE
EEEWWWEEEE
EEEEEEEEEE
EEEWEEEEEE
EWEEEEEEEE
EEEWEEEWEE
DEEWEEEEEE